collagen	(n)胶原蛋白111dev222
hemoglobin	(n)血红蛋白
copepod		(n)桡脚类的动物
herbivorous (adj)食草的
carnivore	(n)食肉动物
plankton	(n)浮游生物
mingle		(vt)混合，混淆
gelatinous	(adj)胶状的
elastic		(adj)有弹性的
devour		(vt)狼吞虎咽地吃光； 吞没，毁灭；
excess		(n)超额量

mackerel	(n)马鲛鱼
hibernation (n)冬眠
manoeuvre	(vt)调遣
shoal		(n)鱼群
sailfish	(n)旗鱼
dorsal		(n)背部的
pyramid		(n)金字塔
manta rays 	(n)蝠鲼
wingspan 	(n)翼展
parasite	(n)寄生虫
solidarity	(n)团结


disingenuous(n)不真诚的，不坦率的；
serendipity	(n)意外新发现
synthesize	(vt)合成

decamp		(vi)（携某物）逃走； 撤营，离开宿营地；
eloquent	(adj)有说明力的
eloquent eloquent
cram		(vi)塞满
bounty		(n)赏金
bunk bed	(n)（附有梯子的） 双层床
bunk 		(n)铺位
cubby		(n)小房间
drab		(n)单调的;土褐色的
drudgery	(n)单调沉闷的工作
eke			(n)竭力维持生计
eke out		竭力维持生计
pittance	(n)少量的收入

shackle		(n)束缚+++++111（merge前的工作区修改）

prominent	(adj)突出的，杰出的； 突起的； 著名的；
astute		(adj)精明的
hamstring	(vt)割断…的腿筋；
pearl delta	珠三角; 珠江三角洲;

embark on the process of modernization-p15
Any international order dominated by a powerful state is 
based on a mix of coercionand consent-p19-p20


by no means	决不; 并不; 绝不，一点也不;
beg the question
beg 		(vt)回避（问题）/乞求、、、

pursuit (n)
pursue	(v)
adolescence

fruition
